11111111111
10000000001
1CP00010001
10000010001
10000l00E01
10000000001
11111111111