11111111111
10000000001
1CP00010001
1000001E001
10000000001
10000000001
11111111111