11111111111
100000000N1
1CPE0000001
10000000001
11111111111