111111111111111111
1EP0000000000000C1
1C00000N0000010001
1111000000C0010001
1C000000N00N0010C1
111111111111111111
