1111111111111111111111111111111111111111
100000110000000C000000000000000000000001
1000000110000000000000000000000000000001
1000C00011000001110000000000011111100001
1000000011111111000000000000011111100001
10N000000000000000000000N0000000C00N0001
1000000000000000000000000000011111100001
1000001100000000110110000000011100000001
100000110000000011E110000000111000000001
1000000000000000111110000000110000000001
1000000000000000111110000000000000000001
100000000000000011C110000000000000000001
1000000000011000000000001100000000000001
1000000000011N000000000N1100000000000001
1000000000001111100011111000000000000001
100110000000000000P000000000000000000001
1011100000000000000000000000000000000001
1111000000000000000000000000000011000001
1111000N00000000000000000110011110001101
100C0000000000000N0000000110011000001101
100000000110000011100000111111000C000111
10000000011000000C0000001110N000000000N1
1111111111111111111111111111111111111111