1111111111111111111111111111111111111111111
10000100C0000000000000000000000E10000000001
100000000000000000000000C001111110000000001
110000100000001C0000000000000C000000000C001
1000000000000010000000000000000000000000001
1000111111111110011111111111111111111110011
10000000000000000000000C0000000001C00000001
1000000011000000000000000000000000000000001
1C00000001000000000000000100000000000000001
1P000000000000001100000001C0000000000001111
100011111100000011000000011111100001001C001
1000000001000000000000000000000001011110001
10000000C1000000000000000000000001000000001
1111111111111111111111111111111111111111111