11111111111111111
1EP00000N0000C111
11111000000101111
1C000000000N00111
11111111111111111
11111111111111111
11111111111111111
11111111111111111
11111111111111111
11111111111111111