1111111111111111111111111111111111111111111
10000100C0000000000000000000000E1000000N001
100000000N00000000000000C001111110000000001
110000100000001C0000000000000C000000000C001
1000000000000010000000000000000000000000001
1000111111111110011111111111111111111110011
10000000000001000000000C0000000001C00000001
1111111111000100000000000000000000000000001
10000000011101000000000001N0000000000000001
10111111000101001100000001C0000000000001111
101000011101010011000000011111100001001C001
1010110101000100000000000000000001011110001
100001CCC10001N00000000000000000010000000P1
1111111111111111111111111111111111111111111