1111111111111111111111111111111111111111
1000010000000000000000000000000010000001
100000000N000000000000000001111110000001
11000010000000100000000000000000000N0001
1000000000000010000000000000000000000001
1000111111111110011111111111111111111111
1000000000000100000000000000000001000001
1111111111000100000000000000000000000001
10000000011101000000000001N0000000000001
1011111100010100110000000100000000000001
1010000111010100110N00000111111000010011
1010110101000100000000000000000001011111
1000010001000100000000000000000001000001
1100001000000010000000000000000000000001
1100001000000000000000000000000000000001
1100001000000010000000000000000000000001
1100001000000010000000000000000000000001
1100001000000010000000000000000000000001
1100001000000010000000000000000000000001
1100001000000000000000000000000000000001
110000100000001000000000000000000000E001
11000010000000100000C00000000000000000P1
1111111111111111111111111111111111111111